#@#.%#@%#.#
%@##.%##.@%
#.%@#%#@%.#
@@%%##%%@@#
##@%..%@@##
