############
#@@##@@##@@#
#..%%..%%..#
#..%%..%%..#
#@@##@@##@@#
############