.....######......
....########.....
...###....###....
..###.####.###...
.###.######.###..
###.########.###.
###.##.##.##.###. 
###############..
###############..
.#############...
..###########....
...#########.....
....#######......
