..########..
.##########.
############
#%@@##%@@##%
############
.##########.
..########..
.##.##.##.##