..@@....@@..
.##......##.
############
#@@######@@#
#@#......#@#
#@#......#@#
############
..########..