....####....
...######...
..########..
.##.##.##.##
.##.##.##.##
############
....####....
....####....
....####....