....%%%%%%%%....
...%########%...
..%##########%..
.%############%.
.%###@##@###@%..
.%###########%..
..%#########%...
...%#######%....
....%#####%.....
.....%###%......
......%#%.......
